File,Date,Genre,hypo-fin,hypo-nonf,para-conj,para-root,para-root2,hypo,para,total
ABOTT-E1,1530,Letters,13,6,12,10,0,19,22,41
ADAMS-1787-2,1787,Non-fiction,385,75,74,334,0,460,408,868
ALBIN-1736-1,1736,Non-fiction,176,26,22,495,0,202,517,719
ALHATTON-E3,1700,Letters,50,19,15,26,0,69,41,110
ALHATTON2-E3,1687,Letters,43,17,20,40,0,60,60,120
AMBASS-E1,1525,Letters,107,18,7,16,0,125,23,148
ANDREWS1-1785-2,1785,Non-fiction,349,149,92,379,26,498,497,995
ANDREWS2-1796-2,1796,Non-fiction,340,117,107,283,9,457,399,856
ANHATTON-E3,1693,Letters,136,30,29,76,1,166,106,272
ANON1-1711-1,1711,Non-fiction,396,73,101,124,8,469,233,702
ANON2-1732-2,1732,Non-fiction,389,80,39,111,0,469,150,619
ANON3-1772-2,1772,Non-fiction,532,130,172,225,0,662,397,1059
ANON4-1791-2,1791,Non-fiction,383,123,112,421,1,506,534,1040
APLUMPT-E1,1503,Letters,112,37,80,37,0,149,117,266
APOOLE-E1,1552,Letters,2,3,3,5,0,5,8,13
ARMIN-E2,1608,Fiction,800,265,472,714,43,1065,1229,2294
ASCH-E1,1566,Non-fiction,739,166,212,268,7,905,487,1392
AUNGIER-E3,1674,Letters,154,51,44,54,0,205,98,303
AUSTEN-180X-1,1807,Letters,426,177,209,465,12,603,686,1289
AUSTEN-1815-2,1815,Fiction,355,157,163,575,46,512,784,1296
AUSTEN-181X-2,1817,Letters,449,146,177,494,19,595,690,1285
AUTHNEW-E2,1611,Bible,2088,232,1610,1467,216,2320,3293,5613
AUTHOLD-E2,1611,Bible,1240,209,1520,684,77,1449,2281,3730
BACON-E2,1605,Non-fiction,1024,163,253,190,5,1187,448,1635
BAIN-1878-1,1878,Non-fiction,307,111,75,363,4,418,442,860
BAKER-1742-2,1742,Non-fiction,385,86,126,267,5,471,398,869
BARCLAY-1743-1,1743,Non-fiction,502,130,108,321,10,632,439,1071
BARCLAY-1743-2,1743,Non-fiction,90,21,18,54,4,111,76,187
BARDSLEY-1807-1,1807,Non-fiction,188,109,89,254,0,297,343,640
BARTON-GRESSWELL-1906-2,1906,Non-fiction,212,79,84,375,3,291,462,753
BEALE-1898-2,1898,Non-fiction,348,134,120,378,5,482,503,985
BEDDINGFIELD-1763-2,1763,Legal,310,73,61,683,188,383,932,1315
BEDYLL-E1,1537,Letters,31,4,2,9,0,35,11,46
BEHN-E3,1668,Fiction,1155,274,361,300,3,1429,664,2093
BELL-1911-2,1911,Non-fiction,393,104,281,391,14,497,686,1183
BENNETT-1911-2,1911,Drama,343,116,89,662,91,459,842,1301
BENSON-1908-1,1908,Non-fiction,527,174,141,285,1,701,427,1128
BENSON-190X-1,1906,Diaries,292,101,173,530,19,393,722,1115
BLUNDEV-E2,1597,Non-fiction,944,188,275,312,43,1132,630,1762
BOETHCO-E1,1556,Non-fiction,2365,381,604,760,271,2746,1635,4381
BOETHEL-E2,1593,Non-fiction,1726,195,474,769,268,1921,1511,3432
BOETHJA-1897-1,1897,Non-fiction,582,91,119,297,46,673,462,1135
BOETHJA-1897-2,1897,Non-fiction,1069,167,197,680,192,1236,1069,2305
BOETHPR-E3,1695,Non-fiction,2012,297,504,849,288,2309,1641,3950
BOETHRI-1785-1,1785,Non-fiction,682,93,136,295,62,775,493,1268
BOETHRI-1785-2,1785,Non-fiction,1402,198,265,734,243,1600,1242,2842
BOSWELL-1768-2,1768,Diaries,401,117,146,277,0,518,423,941
BOSWELL-1776-1,1776,Diaries,348,141,187,622,7,489,816,1305
BOSWELL-1783-2,1783,Diaries,409,142,187,560,1,551,748,1299
BOSWELL-178X-2,1787,Letters,518,149,118,422,27,667,567,1234
BOSWELL-1791-2,1791,Non-fiction,539,117,126,339,6,656,471,1127
BOYLE-E3,1676,Non-fiction,675,104,113,63,0,779,176,955
BOYLECOL-E3,1664,Non-fiction,417,66,102,43,1,483,146,629
BRACKEN-1738-2,1738,Non-fiction,526,97,162,111,4,623,277,900
BRADLEY1-1905-1,1905,Non-fiction,390,103,160,258,6,493,424,917
BRADLEY2-1760-2,1760,Non-fiction,281,82,175,460,0,363,635,998
BRADY-1713-2,1713,Sermon,556,118,114,166,21,674,301,975
BRIGHTLAND-1711-1,1711,Non-fiction,51,13,5,26,6,64,37,101
BRINSLEY-E2,1627,Non-fiction,945,224,123,336,10,1169,469,1638
BRONTE-1848-2,1848,Fiction,394,196,292,612,36,590,940,1530
BROUGH-1867-2,1867,Drama,367,116,87,718,141,483,946,1429
BROUGHAM1-1861-1,1861,Drama,295,122,77,767,153,417,997,1414
BROUGHAM2-1825-2,1825,Non-fiction,343,121,112,244,2,464,358,822
BURNETCHA-E3,1693,Non-fiction,1091,259,383,599,0,1350,982,2332
BURNETROC-E3,1680,Non-fiction,1374,243,278,400,11,1617,689,2306
BURNEY-1768-2,1768,Diaries,449,134,182,546,56,583,784,1367
BURNEY-1782-2,1782,Fiction,477,141,207,426,62,618,695,1313
BURNEY-1792-2,1792,Diaries,456,145,167,470,36,601,673,1274
BURTON1-1762-1,1762,Sermon,358,59,99,251,36,417,386,803
BURTON2-1857-2,1857,Non-fiction,272,96,124,402,5,368,531,899
BUTLER-1726-1,1726,Sermon,470,80,91,218,13,550,322,872
CAPEL-E3,1676,Letters,106,29,30,29,0,135,59,194
CARLYLE-1835-1,1835,Letters,466,111,142,459,12,577,613,1190
CARLYLE-1837-1,1837,Non-fiction,260,59,65,437,32,319,534,853
CARLYLE-1858-2,1858,Non-fiction,329,97,118,306,18,426,442,868
CENTLIVRE-1723-2,1723,Drama,373,116,97,812,180,489,1089,1578
CHAPLAIN-E1,1506,Non-fiction,219,23,137,131,0,242,268,510
CHAPMAN-1774-1,1774,Non-fiction,369,113,97,230,28,482,355,837
CHARLES-1650-E3,1657,Letters,85,10,14,14,0,95,28,123
CHARLES-1670-E3,1676,Letters,70,14,16,16,0,84,32,116
CHATTON-E3,1691,Letters,102,29,45,54,0,131,99,230
CIBBER-1740-1,1740,Non-fiction,581,127,76,227,28,708,331,1039
CLARKE-1730-2,1730,Non-fiction,451,113,95,187,24,564,306,870
CLOWES-E2,1602,Non-fiction,958,208,312,371,3,1166,686,1852
CLOWESOBS-E2,1596,Non-fiction,75,15,31,41,0,90,72,162
CMAELR3-M23,1300,Non-fiction,1027,93,255,368,97,1120,720,1840
CMAELR4-M4,1440,Non-fiction,662,72,118,345,48,734,511,1245
CMANCRIW-1-M1,1228,Non-fiction,3241,323,913,1821,138,3564,2872,6436
CMANCRIW-2-M1,1228,Non-fiction,921,127,276,662,72,1048,1010,2058
CMASTRO-M3,1391,Non-fiction,283,45,103,120,1,328,224,552
CMAYENBI-M2,1340,Non-fiction,3324,444,948,1457,40,3768,2445,6213
CMBENRUL-M3,1415,Non-fiction,1367,174,194,771,8,1541,973,2514
CMBOETH-M3,1380,Non-fiction,817,111,256,192,55,928,503,1431
CMBRUT3-M3,1400,Non-fiction,2900,536,2889,673,7,3436,3569,7005
CMCAPCHR-M4,1454,Non-fiction,2217,368,1586,2284,3,2585,3873,6458
CMCAPSER-M4,1452,Sermon,72,13,31,56,1,85,88,173
CMCLOUD-M3,1390,Non-fiction,959,131,325,277,26,1090,628,1718
CMCTMELI-M3,1390,Fiction,1179,227,514,333,11,1406,858,2264
CMCTPARS-M3,1390,Fiction,1980,295,705,806,21,2275,1532,3807
CMEARLPS-M2,1350,Bible,1078,79,1705,2318,132,1157,4155,5312
CMEDMUND-M4,1438,Non-fiction,134,47,258,45,3,181,306,487
CMEDTHOR-M34,1350,Non-fiction,850,170,352,350,15,1020,717,1737
CMEDVERN-M3,1390,Non-fiction,812,138,207,452,15,950,674,1624
CMEQUATO-M3,1392,Non-fiction,222,16,74,75,0,238,149,387
CMFITZJA-M4,1495,Sermon,255,42,63,142,3,297,208,505
CMGAYTRY-M34,1357,Sermon,427,70,60,103,1,497,164,661
CMGREGOR-M4,1475,Non-fiction,814,207,1721,366,2,1021,2089,3110
CMHALI-M1,1200,Non-fiction,686,64,191,229,22,750,442,1192
CMHILTON-M34,1386,Non-fiction,310,35,95,59,0,345,154,499
CMHORSES-M3,1440,Non-fiction,326,29,84,76,0,355,160,515
CMINNOCE-M4,1497,Sermon,183,29,61,84,3,212,148,360
CMJULIA-M1,1200,Non-fiction,452,105,232,232,19,557,483,1040
CMJULNOR-M34,1400,Non-fiction,320,41,191,146,9,361,346,707
CMKATHE-M1,1200,Non-fiction,642,93,242,233,20,735,495,1230
CMKEMPE-M4,1450,Non-fiction,3745,706,2107,1796,91,4451,3994,8445
CMKENTHO-M1,1125,Sermon,304,15,119,174,36,319,329,648
CMKENTSE-M2,1240,Sermon,245,21,80,113,4,266,197,463
CMLAMB1-M1,1215,Sermon,371,52,150,248,12,423,410,833
CMLAMBX1-MX1,1215,Sermon,1425,77,479,786,45,1502,1310,2812
CMMALORY-M4,1460,Fiction,2582,516,3060,1786,138,3098,4984,8082
CMMANDEV-M3,1400,Non-fiction,2737,496,2593,607,1,3233,3201,6434
CMMARGA-M1,1200,Non-fiction,540,76,263,247,10,616,520,1136
CMMIRK-M34,1405,Sermon,3831,646,1963,1497,42,4477,3502,7979
CMNTEST-M3,1395,Bible,677,67,645,635,111,744,1391,2135
CMORM-M1,1200,Non-fiction,3530,770,55,2370,30,4300,2455,6755
CMOTEST-M3,1395,Bible,465,24,462,291,21,489,774,1263
CMPETERB-M1,1143,Non-fiction,274,30,356,268,0,304,624,928
CMPOLYCH-M3,1377,Non-fiction,1770,332,1830,1626,17,2102,3473,5575
CMPURVEY-M3,1387,Non-fiction,1908,371,1486,854,14,2279,2354,4633
CMREYNAR-M4,1481,Fiction,534,79,240,441,46,613,727,1340
CMREYNES-M4,1485,Non-fiction,271,47,130,217,3,318,350,668
CMROLLEP-M24,1348,Non-fiction,1325,165,379,458,15,1490,852,2342
CMROLLTR-M24,1339,Non-fiction,994,156,367,457,14,1150,838,1988
CMROYAL-M34,1425,Sermon,336,49,134,203,26,385,363,748
CMSAWLES-M1,1200,Sermon,296,43,131,117,6,339,254,593
CMSIEGE-M4,1500,Fiction,305,100,515,232,0,405,747,1152
CMTHORN-MX4,1440,Non-fiction,120,10,18,55,0,130,73,203
CMTRINIT-MX1,1215,Sermon,2607,277,1176,1184,24,2884,2384,5268
CMVICES1-M1,1200,Non-fiction,2114,147,302,1088,37,2261,1427,3688
CMVICES4-M34,1400,Non-fiction,520,83,153,182,3,603,338,941
CMWYCSER-M3,1400,Sermon,3569,667,2758,956,85,4236,3799,8035
coadrian,1050,Non-fiction,53,0,11,162,44,53,217,270
coaelhom,1000,Sermon,4180,195,1831,2370,123,4375,4324,8699
coaelive,1010,Non-fiction,5921,505,3715,4498,134,6426,8347,14773
coalcuin,1150,Non-fiction,401,21,97,312,18,422,427,849
coalex,1000,Non-fiction,396,52,240,277,2,448,519,967
coapollo,1050,Fiction,378,34,284,396,29,412,709,1121
coaugust,1150,Sermon,9,0,0,3,0,9,3,12
COBBETT-1838-2,1838,Non-fiction,308,101,110,203,4,409,317,726
cobede,1050,Non-fiction,5220,462,2048,2667,57,5682,4772,10454
cobenrul,1050,Non-fiction,1444,63,282,837,11,1507,1130,2637
coblick,1000,Sermon,2629,144,1349,1763,102,2773,3214,5987
coboeth,950,Non-fiction,4290,153,898,2282,323,4443,3503,7946
cobyrhtf,1050,Non-fiction,386,19,141,426,2,405,569,974
cocanedgD,1010,Legal,230,3,68,6,0,233,74,307
cocanedgX,1063,Legal,254,2,86,9,0,256,95,351
cocathom1,1000,Sermon,6589,271,2869,5480,195,6860,8544,15404
cocathom2,1000,Sermon,5494,338,2739,5283,182,5832,8204,14036
cochad,1150,Non-fiction,201,12,84,75,2,213,161,374
cochdrul,1063,Non-fiction,1370,80,432,558,24,1450,1014,2464
cochristoph,1050,Non-fiction,95,18,54,54,6,113,114,227
cochronA,1000,Non-fiction,437,29,883,552,0,466,1435,1901
cochronC,1050,Non-fiction,708,51,1360,737,0,759,2097,2856
cochronD,1063,Non-fiction,895,60,1695,771,0,955,2466,3421
cochronE,1150,Non-fiction,1463,120,2235,1263,3,1583,3501,5084
cocura,890,Non-fiction,6847,426,1112,2344,97,7273,3553,10826
cocuraC,890,Non-fiction,202,7,51,65,0,209,116,325
codicts,1100,Non-fiction,208,6,30,136,2,214,168,382
codocu1,800,Legal,106,7,37,39,0,113,76,189
codocu2,900,Legal,119,10,56,59,2,129,117,246
codocu3,1000,Legal,382,18,192,171,0,400,363,763
codocu4,1100,Legal,1,0,0,5,0,1,5,6
coeluc1,1150,Non-fiction,129,6,45,49,17,135,111,246
coeluc2,1150,Non-fiction,39,0,1,27,10,39,38,77
coepigen,1050,Non-fiction,64,1,36,29,0,65,65,130
coeuphr,1010,Non-fiction,214,16,163,232,30,230,425,655
coeust,1010,Non-fiction,346,22,266,262,14,368,542,910
coexodusP,1075,Bible,46,4,64,79,4,50,147,197
cogenesiC,1050,Bible,293,13,279,341,21,306,641,947
cogregdC,1050,Non-fiction,6615,302,2677,3082,185,6917,5944,12861
cogregdH,1050,Non-fiction,1950,128,629,1004,69,2078,1702,3780
coherbar,1050,Non-fiction,901,207,484,1995,0,1108,2479,3587
coinspolD,1010,Legal,195,2,54,83,0,197,137,334
coinspolX,1063,Legal,405,7,111,158,4,412,273,685
cojames,1150,Non-fiction,98,9,61,98,6,107,165,272
colacnu,1000,Non-fiction,174,78,205,632,0,252,837,1089
colaece,950,Non-fiction,1306,319,737,3264,0,1625,4001,5626
colaw1cn,1050,Legal,169,5,85,44,1,174,130,304
colaw2cn,1050,Legal,431,4,183,93,0,435,276,711
colaw5atr,1050,Legal,71,1,57,19,0,72,76,148
colaw6atr,1000,Legal,177,3,76,24,0,180,100,280
colawaf,900,Legal,320,5,29,163,0,325,192,517
colawafint,900,Legal,190,18,40,101,0,208,141,349
colawger,1100,Legal,42,3,4,28,0,45,32,77
colawine,1100,Legal,276,4,33,131,0,280,164,444
colawnorthu,1010,Legal,131,0,29,55,0,131,84,215
colawwllad,1150,Legal,16,2,6,4,0,18,10,28
coleofri,1150,Non-fiction,52,1,40,54,2,53,96,149
COLERIDGE-1825-2,1825,Letters,438,111,119,251,11,549,381,930
COLLIER-1835-1,1835,Drama,287,110,86,778,115,397,979,1376
COLMAN-1805-1,1805,Drama,343,103,112,713,117,446,942,1388
colsigef,1150,Letters,107,6,18,43,1,113,62,175
colsigewB,1150,Letters,199,3,113,96,0,202,209,411
colsigewZ,1050,Letters,624,24,321,299,6,648,626,1274
colwgeat,1100,Letters,179,8,55,72,4,187,131,318
colwsigeT,1063,Letters,22,0,8,8,0,22,16,38
colwsigeXa,1050,Letters,244,9,76,104,2,253,182,435
colwstan1,1050,Letters,277,9,110,164,0,286,274,560
colwstan2,1050,Letters,260,5,75,169,1,265,245,510
comargaC,1150,Non-fiction,231,30,236,160,13,261,409,670
comargaT,1050,Non-fiction,190,33,173,197,14,223,384,607
comart1,1050,Non-fiction,69,11,61,54,1,80,116,196
comart2,1063,Non-fiction,233,26,182,187,4,259,373,632
comart3,1000,Non-fiction,1201,144,1040,1156,13,1345,2209,3554
comarvel,1000,Non-fiction,115,1,41,115,0,116,156,272
comary,1010,Non-fiction,443,62,243,316,25,505,584,1089
COMMISS-E3,1673,Letters,22,3,9,10,0,25,19,44
coneot,1150,Non-fiction,100,5,75,87,2,105,164,269
conicodA,1100,Bible,569,23,364,385,49,592,798,1390
conicodC,1150,Bible,300,10,214,229,26,310,469,779
conicodD,1050,Bible,111,5,92,69,12,116,173,289
conicodE,1150,Bible,109,7,62,64,10,116,136,252
CONWAY-E2,1623,Letters,40,7,8,9,0,47,17,64
CONWAY2-E3,1675,Letters,113,28,33,55,1,141,89,230
COOK1-1776-1,1776,Non-fiction,296,137,229,472,2,433,703,1136
COOK2-1901-2,1901,Non-fiction,231,71,94,323,0,302,417,719
COOKE1-1712-1,1712,Non-fiction,393,132,187,328,0,525,515,1040
COOKE2-1770-2,1770,Non-fiction,249,99,96,255,0,348,351,699
coorosiu,950,Non-fiction,3628,155,1511,1634,27,3783,3172,6955
cootest,1050,Bible,3226,169,2949,3517,208,3395,6674,10069
coprefcath1,1000,Non-fiction,89,3,22,37,0,92,59,151
coprefcath2,1000,Non-fiction,14,2,3,9,0,16,12,28
coprefcura,890,Non-fiction,82,3,18,18,0,85,36,121
coprefgen,1050,Non-fiction,96,7,21,56,1,103,78,181
copreflives,1010,Non-fiction,34,1,3,16,0,35,19,54
coprefsolilo,1150,Non-fiction,38,3,2,12,0,41,14,55
coquadru,1050,Non-fiction,150,33,112,384,0,183,496,679
corood,1150,Non-fiction,475,44,298,316,8,519,622,1141
cosevensl,1010,Non-fiction,642,23,382,235,12,665,629,1294
cosolilo,1150,Non-fiction,1496,70,280,860,95,1566,1235,2801
cosolsat1,1150,Non-fiction,59,3,34,266,47,62,347,409
cosolsat2,950,Non-fiction,56,0,20,65,8,56,93,149
cotempo,1000,Non-fiction,319,8,100,237,1,327,338,665
COUNC-E3,1688,Letters,4,1,1,1,0,5,2,7
coverhom,950,Sermon,2896,167,1225,1709,101,3063,3035,6098
coverhomE,1010,Sermon,262,19,144,246,22,281,412,693
coverhomL,1050,Sermon,158,4,28,64,0,162,92,254
COVERTE-E2,1612,Non-fiction,828,183,520,437,0,1011,957,1968
covinceB,1150,Non-fiction,57,3,16,28,2,60,46,106
covinsal,1063,Bible,253,10,191,97,9,263,297,560
cowsgosp,1050,Bible,4818,215,3391,5462,610,5033,9463,14496
cowulf,1000,Sermon,2136,46,911,743,13,2182,1667,3849
COYNE-1855-2,1855,Drama,314,86,80,749,102,400,931,1331
CROMWELL-E1-H,1537,Letters,23,1,0,1,0,24,1,25
CROMWELL-E1,1530,Letters,88,11,13,21,0,99,34,133
CROSSFIELD-1796-2,1796,Legal,1467,228,160,1832,627,1695,2619,4314
DACRE-E1,1513,Letters,41,11,34,18,0,52,52,104
DALTON-1808-2,1808,Non-fiction,440,86,85,289,19,526,393,919
DARWIN-1835-2,1835,Non-fiction,323,63,122,426,4,386,552,938
DARWIN-1842-2,1842,Non-fiction,334,57,90,244,6,391,340,731
DAVY-1814-2,1814,Non-fiction,328,82,184,288,0,410,472,882
DAVYS-1716-1,1716,Drama,513,158,166,618,73,671,857,1528
DECOURCY-1776-2,1776,Sermon,357,89,104,224,23,446,351,797
DEFOE-1719-1,1719,Fiction,589,148,266,218,5,737,489,1226
DELAPOLE-E1,1538,Letters,17,5,7,3,0,22,10,32
DELL-E3,1688,Letters,30,8,6,9,0,38,15,53
DELONEY-E2,1597,Fiction,1119,285,411,793,86,1404,1290,2694
DERING-E3,1647,Letters,98,24,24,53,1,122,78,200
DICKENS-1837-1,1837,Fiction,385,91,97,494,53,476,644,1120
DISRAELI-1827-2,1827,Fiction,365,92,113,432,29,457,574,1031
DODDRIDGE-1747-1,1747,Non-fiction,686,125,151,159,2,811,312,1123
DOYLE-1905-2,1905,Fiction,443,105,146,577,55,548,778,1326
DPLUMPT-E1,1507,Letters,19,6,6,3,0,25,9,34
DRUMMOND-1718-1,1718,Non-fiction,379,75,36,226,0,454,262,716
DRUMMOND-E3,1690,Letters,167,28,35,43,1,195,79,274
EBEAUM-E1,1503,Letters,23,7,13,12,0,30,25,55
ECUMBERL-E1,1545,Letters,13,3,7,2,0,16,9,25
EDMONDES-E2,1599,Letters,272,67,43,62,0,339,105,444
EDWARD-E1,1551,Diaries,803,234,219,602,0,1037,821,1858
EHATTON-E3,1666,Letters,29,4,4,9,0,33,13,46
EHATTON2-E3,1690,Letters,60,17,20,34,0,77,54,131
ELIZ-1560-E1,1566,Letters,14,4,1,4,0,18,5,23
ELIZ-1570-E2,1573,Letters,62,12,10,7,0,74,17,91
ELIZ-1580-E2,1585,Letters,86,16,4,25,3,102,32,134
ELIZ-1590-E2-H,1598,Letters,121,14,7,17,1,135,25,160
ELIZ-1590-E2-P2,1600,Letters,19,2,1,3,0,21,4,25
ELLIS-1851-2,1851,Non-fiction,423,146,49,252,50,569,351,920
ELYOT-E1,1531,Non-fiction,1103,180,231,248,39,1283,518,1801
EOXINDEN-1650-E3,1658,Letters,17,8,8,10,0,25,18,43
EOXINDEN-1660-E3,1665,Letters,128,41,53,110,0,169,163,332
EOXINDEN-1680-E3,1680,Letters,28,11,10,31,0,39,41,80
EPOOLE-E1,1503,Letters,44,15,14,11,0,59,25,84
ERV-NEW-1881-1,1881,Bible,700,68,483,701,110,768,1294,2062
ERV-NEW-1881-2,1881,Bible,1299,163,1129,730,97,1462,1956,3418
ERV-OLD-1885-1,1885,Bible,351,75,587,206,25,426,818,1244
ERV-OLD-1885-2,1885,Bible,874,140,953,484,52,1014,1489,2503
ESSEX-E2,1600,Legal,498,145,171,275,20,643,466,1109
ESSEXSTATE-E2,1600,Legal,560,155,237,180,16,715,433,1148
EVELYN-E3,1689,Diaries,666,163,92,647,2,829,741,1570
EVERARD-E2,1629,Letters,24,16,11,23,0,40,34,74
FABYAN-E1,1516,Non-fiction,845,126,329,164,2,971,495,1466
FALLOWFIELD-1791-2,1791,Non-fiction,306,78,82,263,1,384,346,730
FARADAY-1859-1,1859,Non-fiction,526,102,161,258,19,628,438,1066
FARQUHAR-E3,1707,Drama,536,121,235,1222,240,657,1697,2354
FAYRER-1900-1,1900,Non-fiction,232,97,210,381,1,329,592,921
FAYRER-1900-2,1900,Non-fiction,65,26,35,86,2,91,123,214
FERGUSON-1756-2,1756,Non-fiction,398,95,137,156,2,493,295,788
FHATTON-E3,1677,Letters,27,8,13,28,0,35,41,76
FIELDING1-1735-2,1735,Drama,496,108,135,620,101,604,856,1460
FIELDING1-1749-1,1749,Fiction,567,121,138,302,22,688,462,1150
FIELDING1-1754-2,1754,Non-fiction,589,115,140,201,4,704,345,1049
FIELDING2-1744-2,1744,Fiction,690,175,188,249,4,865,441,1306
FIENNES-E3,1698,Non-fiction,692,111,252,678,1,803,931,1734
FISHER-E1,1521,Sermon,802,157,228,460,80,959,768,1727
FITZH-E1,1534,Non-fiction,785,202,550,284,5,987,839,1826
FLEMING-1886-1,1886,Non-fiction,297,87,100,366,0,384,466,850
FORMAN-DIARY-E2,1602,Diaries,105,91,319,398,0,196,717,913
FORMAN-E2,1602,Non-fiction,211,40,164,74,0,251,238,489
FORSTER1-1827-2,1827,Non-fiction,403,77,86,383,2,480,471,951
FORSTER2-1910-2,1910,Fiction,330,103,204,783,63,433,1050,1483
FORSTER2-191X-2,1910,Letters,417,119,177,549,51,536,777,1313
FOX-E3,1674,Non-fiction,1003,202,966,211,47,1205,1224,2429
FRIAR-E1,1538,Letters,56,11,15,5,0,67,20,87
FROST-1840-1,1840,Legal,1284,180,208,2211,880,1464,3299,4763
FROST-1840-2,1840,Legal,621,112,128,1003,366,733,1497,2230
FROUDE-1830-1,1830,Sermon,582,131,91,237,22,713,350,1063
FRYER-E3,1677,Non-fiction,805,182,204,369,3,987,576,1563
GARRICK-1759-2,1759,Drama,305,104,121,592,121,409,834,1243
GASCOIGNE-1500-E1,1503,Letters,31,5,16,8,0,36,24,60
GASCOIGNE-1510-E1,1515,Letters,16,4,4,7,0,20,11,31
GAWDY-E2,1588,Letters,125,55,72,142,0,180,214,394
GCROMW-E1,1534,Letters,56,19,12,21,0,75,33,108
GEORGE-1763-1,1763,Letters,296,77,43,180,8,373,231,604
GIBBON-1776-1,1776,Non-fiction,226,78,147,291,0,304,438,742
GIBBON-1789-2,1789,Non-fiction,238,57,131,238,3,295,372,667
GIBSON-1729-2,1729,Non-fiction,520,94,114,109,0,614,223,837
GIFFORD-E2,1593,Non-fiction,1296,240,346,823,171,1536,1340,2876
GISBORNE-1802-2,1802,Sermon,482,78,48,328,99,560,475,1035
GLADSTONE-1873-1,1873,Letters,480,177,123,515,25,657,663,1320
GODWIN-1805-1,1805,Fiction,384,135,127,438,8,519,573,1092
GOLDSMITH-1766-2,1766,Fiction,537,155,192,358,28,692,578,1270
GOLDSMITH-1773-1,1773,Drama,396,126,104,696,98,522,898,1420
GORDON-1781-2,1781,Legal,1748,390,313,1764,401,2138,2478,4616
GPOOLE-1500-E1,1504,Letters,114,22,39,35,0,136,74,210
GPOOLE-1510-E1,1515,Letters,59,15,23,13,0,74,36,110
GRAFTING-1780-1,1780,Non-fiction,407,89,122,232,1,496,355,851
GREEN-1874-2,1874,Non-fiction,282,111,169,313,4,393,486,879
GREVILLE-1827-2,1827,Diaries,594,131,201,403,1,725,605,1330
GREVILLE-1855-2,1855,Diaries,594,176,189,326,4,770,519,1289
GREY-1914-2,1914,Letters,760,191,77,381,3,951,461,1412
GREY-E1,1523,Letters,4,0,1,2,0,4,3,7
HARDY-1874-2,1874,Fiction,412,133,190,633,61,545,884,1429
HARE-183X-2,1832,Sermon,500,131,105,377,63,631,545,1176
HARLEY-E2,1629,Letters,131,37,53,86,0,168,139,307
HARLEYEDW-E2,1638,Letters,224,46,70,129,0,270,199,469
HARMAN-E1,1568,Fiction,843,189,478,530,48,1032,1056,2088
HARRIS-177X-2,1775,Letters,517,171,122,302,0,688,424,1112
HARRIS-1797-2,1797,Letters,866,165,64,209,0,1031,273,1304
HATCHER-E2,1580,Letters,8,3,3,4,0,11,7,18
HAYDON-1808-1,1808,Diaries,396,123,144,553,47,519,744,1263
HAYDON-1842-2,1842,Diaries,409,103,163,661,25,512,849,1361
HAYWARD-E2,1612,Non-fiction,753,182,192,401,9,935,602,1537
HEBER-1815-2,1815,Sermon,486,107,93,137,6,593,236,829
HENRY-1510-E1,1515,Letters,16,4,2,7,0,20,9,29
HENRY-1520-E1,1524,Letters,93,12,13,13,0,105,26,131
HENRY-1530-E1,1531,Letters,25,7,7,4,0,32,11,43
HERSCHEL-1797-1,1797,Non-fiction,284,106,117,353,0,390,470,860
HIND-1707-1,1707,Non-fiction,461,136,100,191,0,597,291,888
HOBSON-173X-2,1733,Diaries,340,75,83,421,0,415,504,919
HOBY-E2,1600,Diaries,485,149,970,1161,0,634,2131,2765
HODGKIN-1880-2,1880,Non-fiction,329,114,71,226,2,443,299,742
HOLCROFT-1794-2,1794,Fiction,567,130,141,409,63,697,613,1310
HOLMES-LETTERS-1749-1,1749,Letters,375,76,74,115,7,451,196,647
HOLMES-TRIAL-1749-1,1749,Legal,1051,146,269,1092,521,1197,1882,3079
HOOKE-E3,1665,Non-fiction,1087,191,257,205,3,1278,465,1743
HOOKER-A-E2,1614,Sermon,498,76,73,243,44,574,360,934
HOOKER-B-E2,1614,Sermon,443,57,66,261,63,500,390,890
HOOLE-E3,1660,Non-fiction,1072,258,177,199,4,1330,380,1710
HOXINDEN-1640-E3,1648,Letters,192,51,31,128,2,243,161,404
HOXINDEN-1650-E3,1652,Letters,304,59,56,114,0,363,170,533
HOXINDEN-1660-E3,1663,Letters,221,56,60,157,0,277,217,494
HUME-1757-2,1757,Non-fiction,375,119,112,260,0,494,372,866
HUME-1776-2,1776,Non-fiction,109,39,46,97,0,148,143,291
HUNT-1844-2,1844,Non-fiction,327,72,81,247,4,399,332,731
HUXLEY-186X-2,1867,Non-fiction,464,96,94,236,36,560,366,926
HUXLEY-1889-2,1889,Non-fiction,229,56,69,116,1,285,186,471
INCHBALD-1793-2,1793,Drama,427,146,120,598,92,573,810,1383
INNES-1902-2,1902,Non-fiction,250,112,126,367,1,362,494,856
INTERVIEW-E1,1520,Letters,14,2,3,2,0,16,5,21
IPLUMPT-E1,1507,Letters,17,6,21,8,0,23,29,52
JACKSON-E3,1655,Letters,28,3,12,8,0,31,20,51
JBARRING-E2,1629,Letters,142,50,39,71,0,192,110,302
JETAYLOR-E3,1673,Sermon,498,123,325,280,3,621,608,1229
JETAYLORMEAS-E3,1662,Non-fiction,501,94,214,169,3,595,386,981
JOHNSON-1759-2,1759,Fiction,456,149,161,396,17,605,574,1179
JOHNSON-176X-2,1767,Letters,544,162,141,417,11,706,569,1275
JOHNSON-1775-1,1775,Letters,503,171,157,559,31,674,747,1421
JOHNSTONE-1786-2,1786,Drama,321,108,121,652,135,429,908,1337
JOPINNEY-E3,1688,Letters,158,48,64,119,0,206,183,389
JOTAYLOR-E2,1630,Non-fiction,1266,258,524,527,9,1524,1060,2584
JOXINDEN-E2,1633,Letters,120,49,45,46,0,169,91,260
JPINNEY-E3,1686,Letters,58,18,31,44,10,76,85,161
JUBARRING-E2,1630,Letters,86,25,27,19,0,111,46,157
JUDALL-E2,1590,Legal,533,137,160,276,54,670,490,1160
JUSTICE-1739-2,1739,Non-fiction,518,133,275,436,1,651,712,1363
KEIMER-1718-2,1718,Non-fiction,846,140,199,531,39,986,769,1755
KIMBER-1742-1,1742,Non-fiction,432,120,132,210,0,552,342,894
KINGLAKE-1844-2,1844,Non-fiction,424,134,182,317,3,558,502,1060
KINGSLEY-1897-2,1897,Non-fiction,411,96,232,394,8,507,634,1141
KIRKLAND-1774-2,1774,Non-fiction,405,62,147,203,21,467,371,838
KNOX-1786-2,1786,Non-fiction,312,64,101,363,3,376,467,843
KNYVETON-1752-ACTUALLY-GRAY-1937-2,1937,Diaries,424,106,253,176,7,530,436,966
KNYVETT-1620-E2-H,1622,Letters,148,49,66,104,0,197,170,367
KNYVETT-1620-E2-P1,1625,Letters,243,81,89,195,0,324,284,608
KNYVETT-1630-E2,1637,Letters,157,43,87,131,0,200,218,418
KOXINDEN-E2,1636,Letters,28,10,15,32,0,38,47,85
KPASTON-E2,1625,Letters,133,42,45,75,1,175,121,296
KSCROPE-1530-E1,1536,Letters,8,5,5,4,0,13,9,22
KSCROPE-1580-E2,1584,Letters,4,5,3,7,0,9,10,19
LANCASTER1-1806-1,1806,Non-fiction,351,132,120,372,8,483,500,983
LANCASTER2-1794-2,1794,Non-fiction,302,125,70,199,0,427,269,696
LANGF-E3,1696,Non-fiction,1046,215,243,317,0,1261,560,1821
LATIMER-E1,1549,Sermon,766,159,317,524,76,925,917,1842
LAWRENCE-1908-2,1908,Letters,347,110,89,684,61,457,834,1291
LAYARD-1894-2,1894,Non-fiction,416,155,134,378,4,571,516,1087
LAYER-1723-2,1723,Legal,2571,673,626,1756,289,3244,2671,5915
LEATHES-1913-2,1913,Non-fiction,332,123,115,508,14,455,637,1092
LEFEVRE-1843-2,1843,Non-fiction,352,102,151,392,27,454,570,1024
LELAND-E1,1539,Non-fiction,550,47,370,792,0,597,1162,1759
LIDDON-1889-2,1889,Sermon,445,70,124,295,17,515,436,951
LIND-1753-1,1753,Non-fiction,307,95,65,199,0,402,264,666
LINGARD-1823-2,1823,Non-fiction,283,141,141,281,1,424,423,847
LISLE-E3,1685,Legal,1010,181,285,1046,360,1191,1691,2882
LOCKE-E3,1685,Non-fiction,1074,272,249,364,20,1346,633,1979
LONG-1866-1,1866,Non-fiction,433,104,209,332,0,537,541,1078
LORDS-E1,1539,Letters,19,7,2,5,0,26,7,33
LOUDON-1806-2,1806,Non-fiction,313,92,83,270,0,405,353,758
LYELL-1830-1,1830,Non-fiction,396,87,84,194,4,483,282,765
MACAULAY-1833-2,1833,Non-fiction,306,107,79,436,7,413,522,935
MACAULAY-1843-2,1843,Non-fiction,405,156,159,401,8,561,568,1129
MACAULAY-1849-2,1849,Non-fiction,335,98,83,332,1,433,416,849
MACHYN-E1,1556,Diaries,261,68,494,535,1,329,1030,1359
MACQUARIE-1815-2,1815,Non-fiction,186,90,144,331,0,276,475,751
MADOX-E2,1582,Diaries,1017,205,475,739,5,1222,1219,2441
MANNERS-E1,1535,Letters,19,2,5,2,0,21,7,28
MARCHES-E1,1537,Letters,29,2,0,2,0,31,2,33
MARKHAM-E2,1615,Non-fiction,831,175,201,277,0,1006,478,1484
MASHAM-E2,1630,Letters,154,72,51,128,3,226,182,408
MATHEWS-1875-2,1875,Drama,255,75,87,822,122,330,1031,1361
MAURICE-1857-2,1857,Sermon,581,112,41,373,45,693,459,1152
MAXWELL-1747-1,1747,Non-fiction,653,160,157,278,15,813,450,1263
MEMO-E3,1675,Letters,73,11,13,14,0,84,27,111
MEREDITH-188X-2,1886,Letters,226,146,129,624,6,372,759,1131
MEREDITH-1895-1,1895,Fiction,295,125,115,514,14,420,643,1063
MERRYTAL-E1,1526,Fiction,1429,293,643,558,20,1722,1221,2943
MHATTON-E3,1678,Letters,41,4,3,18,0,45,21,66
MHOWARD-E1,1536,Letters,23,4,4,2,0,27,6,33
MIDDLET-E2,1630,Drama,530,129,116,1486,227,659,1829,2488
MIDSHIPMAN-1767-2,1767,Non-fiction,414,116,167,447,3,530,617,1147
MILES1-1873-2,1873,Non-fiction,304,119,85,281,19,423,385,808
MILES2-1893-2,1893,Non-fiction,383,107,98,292,5,490,395,885
MILL-1854-2,1854,Letters,567,122,167,388,23,689,578,1267
MILL-1871-2,1871,Letters,443,154,114,254,6,597,374,971
MILTON-E3,1670,Non-fiction,750,202,238,365,5,952,608,1560
MONTAGU-1718-1,1718,Letters,418,115,125,321,1,533,447,980
MONTAGUE-E3,1680,Letters,84,26,24,56,0,110,80,190
MONTEFIORE-1836-1,1836,Non-fiction,374,123,166,375,7,497,548,1045
MOORE-181X-2,1819,Diaries,405,129,145,481,14,534,640,1174
MORELET1-E1,1529,Letters,33,7,9,5,0,40,14,54
MORELET2-E1,1534,Letters,560,103,131,99,2,663,232,895
MORERIC-E1,1613,Non-fiction,1290,208,304,237,24,1498,565,2063
MOREWOL-E1,1524,Letters,250,41,36,39,0,291,75,366
MORRIS-172X-2,1723,Diaries,321,140,235,441,0,461,676,1137
MORTON-1813-2,1813,Drama,277,80,85,774,114,357,973,1330
MOWNTAYNE-E1,1555,Non-fiction,549,176,377,522,73,725,972,1697
MOXINDEN-E2,1640,Letters,65,16,9,28,0,81,37,118
MROPER-E1,1534,Letters,639,92,152,105,13,731,270,1001
MTUDOR-1510-E1,1515,Letters,87,19,22,13,0,106,35,141
MTUDOR-1520-E1,1528,Letters,13,3,5,3,0,16,8,24
NEVILL-E1,1505,Letters,5,1,8,3,0,6,11,17
NEWCOME-NEW-1796-1,1796,Bible,706,74,492,706,109,780,1307,2087
NEWCOME-NEW-1796-2,1796,Bible,569,30,288,461,54,599,803,1402
NFERRAR-E2,1626,Letters,21,10,10,15,0,31,25,56
NFERRAR-E2-P2,1631,Letters,21,8,8,19,0,29,27,56
NHADD-1700-E3,1706,Letters,30,5,12,34,0,35,46,81
NHADD-1710-E3,1719,Letters,24,7,7,19,0,31,26,57
NIGHTINGALE-1848-2,1848,Letters,428,131,185,445,26,559,656,1215
NIGHTINGALE-188X-1,1889,Letters,170,46,30,140,25,216,195,411
NIGHTINGALE-189X-1,1894,Letters,267,92,69,263,22,359,354,713
OATES-E3,1685,Legal,1103,199,509,1293,390,1302,2192,3494
OCONNELL-1844-2,1844,Legal,1910,444,400,3172,818,2354,4390,6744
OFFICER-1744-1,1744,Non-fiction,364,92,173,327,0,456,500,956
OKEEFFE-1767-2,1767,Drama,318,83,70,546,77,401,693,1094
OKEEFFE-1826-1,1826,Non-fiction,204,66,115,353,6,270,474,744
OLDMIXON-1716-2,1716,Non-fiction,589,141,159,277,7,730,443,1173
OMAN-1895-1,1895,Non-fiction,231,147,172,400,2,378,574,952
OSBORNE-E3,1676,Letters,87,25,25,17,0,112,42,154
OSMER-1759-2,1759,Non-fiction,451,123,115,213,6,574,334,908
OWEN-1813-2,1813,Non-fiction,380,135,107,261,16,515,384,899
OWEN-1847-2,1847,Non-fiction,393,77,125,231,24,470,380,850
OWEN-1857-2,1857,Non-fiction,434,112,217,296,3,546,516,1062
PALGRAVE1-185X-2,1859,Non-fiction,303,95,150,323,4,398,477,875
PALGRAVE2-1863-2,1863,Non-fiction,276,103,148,296,10,379,454,833
PENNY-E3,1686,Fiction,1143,312,519,755,105,1455,1379,2834
PEPYS-E3,1667,Diaries,852,195,414,229,2,1047,645,1692
PERROTT-E2,1598,Non-fiction,925,178,224,230,11,1103,465,1568
PETTIT-E2,1625,Letters,36,11,16,19,0,47,35,82
PETTIT2-E2,1627,Letters,37,5,7,14,0,42,21,63
PEYTON-E2,1632,Letters,22,8,1,19,0,30,20,50
PHENRY-E3,1685,Letters,115,24,25,79,3,139,107,246
PLANCHE-1827-2,1827,Drama,331,109,115,681,98,440,894,1334
PLANCHE-1846-2,1846,Drama,355,112,121,562,78,467,761,1228
POORE-1876-1,1876,Non-fiction,270,85,105,268,4,355,377,732
POPE-172X-2,1724,Letters,531,118,101,262,11,649,374,1023
PRIESTLEY-1765-2,1765,Non-fiction,528,106,90,217,28,634,335,969
PRIESTLEY-1769-1,1769,Non-fiction,544,90,88,204,4,634,296,930
PROPOSALS-E3,1677,Letters,22,6,5,4,0,28,9,37
PROUD-1620-E2,1626,Letters,3,5,6,8,0,8,14,22
PROUD-1630-E2,1636,Letters,36,12,12,10,0,48,22,70
PURVER-NEW-1764-1,1764,Bible,830,66,309,731,109,896,1149,2045
PURVER-NEW-1764-2,1764,Bible,1500,159,635,911,104,1659,1650,3309
PURVER-OLD-1764-1,1764,Bible,506,59,204,303,25,565,532,1097
PURVER-OLD-1764-2,1764,Bible,1156,129,403,554,49,1285,1006,2291
PUSEY-186X-1,1866,Sermon,448,86,69,321,19,534,409,943
PUSEY-187X-2,1871,Sermon,513,85,89,400,36,598,525,1123
RALEIGH-E2,1600,Legal,909,234,225,810,61,1143,1096,2239
RCECIL-E2,1596,Letters,213,39,48,53,1,252,102,354
READE-1863-1,1863,Non-fiction,479,117,171,516,20,596,707,1303
RECORD-E1,1551,Non-fiction,1171,84,367,420,1,1255,788,2043
REEVE-1777-1,1777,Fiction,394,148,199,533,35,542,767,1309
RFERRAR-E2,1633,Letters,7,3,4,7,1,10,12,22
RHADDJR-E3,1692,Letters,4,3,4,15,0,7,19,26
RHADDSR-1650-E3,1658,Letters,93,31,22,54,0,124,76,200
RHADDSR-1670-E3,1673,Letters,136,48,30,150,0,184,180,364
RHADDSR-1680-E3,1688,Letters,12,4,3,4,0,16,7,23
RHADDSR-1700-E3,1703,Letters,41,8,13,34,0,49,47,96
RHADDSR-1710-E3,1712,Letters,8,4,3,10,0,12,13,25
RICH-E2,1624,Letters,104,18,21,29,1,122,51,173
RICHARDSON-1858-2,1858,Non-fiction,378,68,53,210,0,446,263,709
ROBERTS-1726-2,1726,Non-fiction,562,103,185,194,0,665,379,1044
ROBERTSON-1792-2,1792,Non-fiction,195,33,167,443,0,228,610,838
ROPER-E1,1555,Non-fiction,962,182,156,248,23,1144,427,1571
ROXINDEN-1600-E2,1607,Letters,12,4,2,6,0,16,8,24
ROXINDEN-1620-E2,1626,Letters,37,9,12,16,0,46,28,74
ROXINDEN2-E2,1630,Letters,30,5,10,10,0,35,20,55
RPLUMPT-E1,1536,Letters,46,14,16,14,0,60,30,90
RPLUMPT2-E1,1502,Letters,46,10,28,7,0,56,35,91
RUSKIN-1835-1,1835,Diaries,283,61,110,367,0,344,477,821
RUSKIN-1882-2,1882,Diaries,196,53,166,253,12,249,431,680
RUSSELL-E1,1538,Letters,14,6,2,6,0,20,8,28
RYDER-1716-1,1716,Diaries,585,153,207,411,1,738,619,1357
SALMON-1724-2,1724,Non-fiction,404,136,174,144,1,540,319,859
SAVILL-E1,1545,Letters,87,20,39,64,0,107,103,210
SHAKESP-E2,1599,Drama,566,132,198,1437,256,698,1891,2589
SHAW-1903-2,1903,Drama,385,143,130,668,92,528,890,1418
SHERIDAN-1756-2,1756,Non-fiction,607,108,78,226,27,715,331,1046
SKEAVINGTON-184X-1,1845,Non-fiction,462,133,136,243,0,595,379,974
SMITH-E2,1591,Sermon,1207,210,338,663,48,1417,1049,2466
SMOLLETT-175X-2,1757,Letters,447,135,128,350,12,582,490,1072
SOMERS-E3,1697,Letters,42,15,12,14,0,57,26,83
SOUTHARD-E3,1686,Letters,30,4,11,10,0,34,21,55
SOUTHEY-1813-1,1813,Non-fiction,382,137,174,404,4,519,582,1101
SPENCER-1680-E3,1688,Letters,37,13,7,20,0,50,27,77
SPENCER-1700-E3,1708,Letters,125,25,18,33,0,150,51,201
ST-JOHN-1711-2,1711,Letters,673,156,109,283,2,829,394,1223
STAT-1500-E1,1511,Legal,280,13,6,12,0,293,18,311
STAT-1510-E1,1515,Legal,70,0,1,0,0,70,1,71
STAT-1530-E1,1533,Legal,362,43,21,24,0,405,45,450
STAT-1540-E1,1543,Legal,235,20,19,5,0,255,24,279
STAT-1550-E1,1553,Legal,210,17,19,5,0,227,24,251
STAT-1560-E1,1563,Legal,168,16,18,1,0,184,19,203
STAT-1570-E2,1572,Legal,172,14,15,5,0,186,20,206
STAT-1580-E2,1585,Legal,251,20,20,6,0,271,26,297
STAT-1590-E2,1593,Legal,198,21,14,8,0,219,22,241
STAT-1600-E2,1607,Legal,265,26,22,8,0,291,30,321
STAT-1620-E2,1626,Legal,189,11,10,5,0,200,15,215
STAT-1640-E2,1640,Legal,233,31,34,5,0,264,39,303
STAT-1660-E3,1663,Legal,309,33,29,10,0,342,39,381
STAT-1670-E3,1671,Legal,109,21,22,2,0,130,24,154
STAT-1690-E3,1697,Legal,869,103,125,21,0,972,146,1118
STATUTES-171X-1,1716,Legal,276,24,9,22,0,300,31,331
STATUTES-1745-1,1745,Legal,241,27,10,35,0,268,45,313
STATUTES-1775-1,1775,Legal,251,39,18,34,0,290,52,342
STATUTES-1805-1,1805,Legal,269,22,3,27,0,291,30,321
STATUTES-1835-1,1835,Legal,373,37,30,47,18,410,95,505
STATUTES-1865-1,1865,Legal,250,61,64,74,0,311,138,449
STATUTES-1895-1,1895,Legal,226,36,51,132,0,262,183,445
STEVENS-1745-1,1745,Drama,413,172,134,653,74,585,861,1446
STEVENSO-E1,1558,Drama,741,153,154,945,192,894,1291,2185
STOKES-1887-2,1887,Non-fiction,438,80,81,201,7,518,289,807
STOW-E2,1580,Non-fiction,739,157,257,316,1,896,574,1470
STRUTT-1890-1,1890,Non-fiction,339,104,102,353,5,443,460,903
STRYPE-E3,1664,Letters,147,26,41,80,0,173,121,294
STURT-1890-2,1890,Diaries,381,130,122,513,42,511,677,1188
STURT-1914-2,1914,Diaries,381,140,131,411,30,521,572,1093
SURETY-E1,1549,Letters,4,2,2,1,0,6,3,9
SWIFT-1726-2,1726,Fiction,479,117,139,241,0,596,380,976
SWIFT-1735-2,1735,Letters,494,141,141,293,9,635,443,1078
TALBOT-1901-1,1901,Sermon,448,94,114,356,29,542,499,1041
TALBOT-E2,1593,Letters,8,4,3,11,0,12,14,26
TBARRING-E2,1630,Letters,69,28,21,46,0,97,67,164
TEMPLE-1914-2,1914,Sermon,531,118,161,326,20,649,507,1156
THACKERAY-1855-2,1855,Fiction,453,100,132,475,47,553,654,1207
THOMPSON-1859-2,1859,Non-fiction,247,86,123,363,0,333,486,819
THOMSON-1862-2,1862,Non-fiction,369,84,63,171,2,453,236,689
THOWARD-E1-H,1513,Letters,22,3,3,1,0,25,4,29
THOWARD-E1-P1,1519,Letters,12,4,9,2,0,16,11,27
THOWARD2-E2,1571,Legal,1710,387,485,1244,95,2097,1824,3921
THRING-187X-1,1871,Diaries,392,141,141,463,16,533,620,1153
THRING-1883-2,1883,Non-fiction,452,117,73,354,12,569,439,1008
THROCKM-E1,1554,Legal,872,192,266,486,95,1064,847,1911
TILLOTS-A-E3,1670,Sermon,356,91,114,124,14,447,252,699
TILLOTS-B-E3,1679,Sermon,567,137,135,145,9,704,289,993
TILLOTS-C-E3,1680,Sermon,366,67,97,96,20,433,213,646
TINDALL-1814-1,1814,Non-fiction,398,85,94,274,5,483,373,856
TORKINGT-E1,1517,Non-fiction,685,94,473,495,0,779,968,1747
TOWNLEY-1746-1,1746,Legal,533,86,166,364,105,619,635,1254
TREVELYAN-1911-2,1911,Non-fiction,288,127,106,270,12,415,388,803
TREVELYAN-1913-2,1913,Non-fiction,336,104,132,340,4,440,476,916
TRINCOLL-E2,1594,Letters,6,1,1,2,0,7,3,10
TROLLOPE-1879-2,1879,Fiction,489,159,170,439,38,648,647,1295
TROLLOPE-1882-1,1882,Non-fiction,441,159,204,339,5,600,548,1148
TUNSTALL-E1-H,1517,Letters,92,11,12,12,0,103,24,127
TUNSTALL-E1-P1,1521,Letters,67,14,15,15,0,81,30,111
TURNER-E1,1568,Non-fiction,1028,104,258,263,7,1132,528,1660
TURNER1-1799-1,1799,Non-fiction,319,122,122,367,3,441,492,933
TURNER2-1800-1,1800,Non-fiction,317,109,111,309,1,426,421,847
TURNER3-1722-2,1722,Non-fiction,324,53,55,99,1,377,155,532
TURNERHERB-E1,1562,Non-fiction,35,9,9,31,0,44,40,84
TYNDNEW-E1,1534,Bible,2145,229,1601,1556,216,2374,3373,5747
TYNDOLD-E1,1530,Bible,1414,190,1385,625,74,1604,2084,3688
UDALL-E1,1538,Drama,623,143,190,1084,218,766,1492,2258
UNDERHILL-E1,1562,Non-fiction,291,69,93,199,12,360,304,664
VANBR-E3,1696,Drama,1062,314,283,1394,227,1376,1904,3280
VICARY-E1,1548,Non-fiction,943,166,570,432,0,1109,1002,2111
VICTORIA-186X-DIARY-2,1865,Diaries,486,101,164,480,11,587,655,1242
VICTORIA-186X-OFFICIAL-LETTERS-2,1865,Letters,584,173,118,283,17,757,418,1175
VICTORIA-186X-PRIVATE-LETTERS-1,1865,Letters,444,139,193,396,14,583,603,1186
WALPOLE-174X-1,1744,Letters,537,142,135,412,25,679,572,1251
WALPOLE-179X-2,1793,Letters,577,124,164,362,44,701,570,1271
WALTON-E3,1676,Non-fiction,919,208,365,385,34,1127,784,1911
WATSON-1817-1,1817,Legal,1308,254,245,1886,604,1562,2735,4297
WATTS-1726-2,1726,Non-fiction,351,47,110,188,1,398,299,697
WCECIL-1560-E1,1565,Letters,68,22,25,35,0,90,60,150
WCECIL-1580-E2,1587,Letters,72,14,19,17,0,86,36,122
WEATHERS-1913-1,1913,Non-fiction,257,97,121,252,2,354,375,729
WEBSTER-1718-1,1718,Non-fiction,116,27,28,38,6,143,72,215
WELLESLEY-1815-1,1815,Letters,564,157,141,274,4,721,419,1140
WESLEY-174X-1,1745,Diaries,439,121,190,473,11,560,674,1234
WESLEY-1750-2,1750,Sermon,195,24,35,114,33,219,182,401
WESLEY-1755-2,1755,Sermon,307,44,57,177,20,351,254,605
WHEWELL-1837-1,1837,Non-fiction,416,81,117,249,24,497,390,887
WHITE-1784-2,1784,Sermon,418,124,100,263,14,542,377,919
WHITEFIELD-1737-2,1737,Sermon,531,106,113,168,39,637,320,957
WILDE-1895-1,1895,Drama,392,119,94,705,80,511,879,1390
WILLIAM-1832-2,1832,Letters,599,132,85,145,0,731,230,961
WOLLASTON-1793-1,1793,Sermon,475,131,96,210,7,606,313,919
WOLLSTONECRAFT-1787-2,1787,Non-fiction,505,163,186,394,17,668,597,1265
WOLSEY-E1,1529,Letters,176,34,23,37,1,210,61,271
WOOD-1864-2,1864,Non-fiction,402,101,129,249,4,503,382,885
WPASTON2-E2,1625,Letters,10,5,4,20,0,15,24,39
WPLUMPT-1500-E1,1503,Letters,20,3,13,8,0,23,21,44
WPLUMPT-1510-E1,1516,Letters,7,2,4,3,0,9,7,16
WPLUMPT-1530-E1,1538,Letters,14,3,6,4,0,17,10,27
WYLD-1725-2,1725,Non-fiction,330,56,142,145,0,386,287,673
YONGE-1865-1,1865,Fiction,437,148,176,434,39,585,649,1234
ZOUCH-E3,1649,Letters,25,4,4,3,0,29,7,36