File,Date,Genre,hypo-fin,hypo-nonf,para-conj,para-root,para-root2,hypo,para,total
0842-STRASBBFM-BFM-P,842,Legal,10,2,1,2,0,12,3,15
0885-EULALIBFM-BFM-P,885,NarrativeVerse,13,7,2,19,0,20,21,41
0980-LEGER-PENN-V,980,NarrativeVerse,90,38,32,148,2,128,182,310
1000-PASSION-BFM-P,1000,NarrativeVerse,131,55,32,316,10,186,358,544
1050-ALEXIS-PENN-V,1050,NarrativeVerse,245,122,58,444,40,367,542,909
1100-ROLAND-MCVF-V,1100,NarrativeVerse,1006,472,270,3280,85,1478,3635,5113
1117-LAPIDAL-BFM-R,1117,DidacticVerse,657,148,288,659,10,805,957,1762
1120-BRENDAN-MCVF-R,1120,NarrativeVerse,627,141,235,957,54,768,1246,2014
1128-BESTIAIRE-BFM-R,1128,DidacticVerse,1028,209,321,1084,28,1237,1433,2670
1130-GORMONT-BFM-R,1130,NarrativeVerse,157,55,58,333,12,212,403,615
1138-JUISE-BFM-R,1138,Sermon,269,57,47,305,22,326,374,700
1150-LAPIDFP-BFM-P,1150,DidacticProse,348,73,170,291,4,421,465,886
1150-PSORNE-BFM-P,1150,Bible,14,1,31,39,2,15,72,87
1150-LEIS-WILLELME-MCVF-P,1150,Legal,271,54,38,55,2,325,95,420
1150-QLR-BFM-P,1150,NarrativeProse,2301,437,1866,2163,305,2738,4334,7072
1155-ENEAS1-BFM-R,1155,NarrativeVerse,1805,721,548,3262,190,2526,4000,6526
1155-ENEAS2-BFM-R,1155,NarrativeVerse,1360,581,343,2340,172,1941,2855,4796
1165-PROVSERLO-BFM-P,1165,DidacticProse,55,13,1,87,2,68,90,158
116X-MARIE-DE-FRANCE-MCVF-R,1165,NarrativeVerse,1656,676,428,3214,188,2332,3830,6162
1173-BECKET-BFM-R,1173,NarrativeVerse,2938,1447,1231,3235,134,4385,4600,8985
1174-BENDUC1B-BFM-R,1174,NarrativeVerse,1271,387,327,1522,118,1658,1967,3625
1175-FANTOSME-BFM-R,1175,NarrativeVerse,776,386,308,1217,86,1162,1611,2773
1175-MIRNDORL-BFM-R,1175,NarrativeVerse,49,11,10,68,1,60,79,139
1177-YVAIN-MCVF-R,1177,NarrativeVerse,2909,866,1469,1840,210,3775,3519,7294
1183-ADGAR-BFM-R,1183,NarrativeVerse,3120,862,813,3274,337,3982,4424,8406
1185-COBE-BFM-R,1185,NarrativeVerse,218,65,66,115,10,283,191,474
1190-BLONDNESLE-BFM-R,1190,NarrativeVerse,420,184,117,276,28,604,421,1025
1190-DIALGREG1-BFM-P,1190,DidacticProse,1060,225,381,332,97,1285,810,2095
1190-DIALGREG2-BFM-P,1190,DidacticProse,1132,234,429,263,100,1366,792,2158
1190-SBERNAN-BFM-P,1190,Sermon,6307,1007,2048,2675,819,7314,5542,12856
1190-BORON-PENN-R,1190,NarrativeVerse,1538,380,568,1212,219,1918,1999,3917
1194-CHIEVRES-MCVF-P,1194,Legal,99,36,21,24,0,135,45,180
1200-DIALAME-BFM-P,1200,DidacticProse,318,77,197,516,83,395,796,1191
1200-SERMMADN-BFM-P,1200,Sermon,159,33,73,72,9,192,154,346
1205-CLARI-MCVF-P,1205,NarrativeProse,2385,544,965,1238,109,2929,2312,5241
1210-BORON-PENN-P,1210,NarrativeProse,1345,302,799,576,172,1647,1547,3194
1212-EUSTACE-FISHER-PENN-R,1212,NarrativeVerse,650,198,144,651,42,848,837,1685
1225-QUESTE-MCVF-P,1225,NarrativeProse,2732,641,1665,845,207,3373,2717,6090
122X-AGNES-MCVF-P,1225,Sermon,325,71,163,176,14,396,353,749
122X-AUCASSIN-MCVF-M,1225,NarrativeMixed,528,137,228,633,58,665,919,1584
122X-EUSTACE-MURRAY-PENN-P,1225,NarrativeProse,425,83,210,321,31,508,562,1070
122X-EUSTACE-PETERSEN-PENN-R,1225,NarrativeVerse,753,198,288,587,86,951,961,1912
122X-PSEUDO-TURPIN-MCVF-P,1225,NarrativeProse,210,49,121,122,8,259,251,510
122X-PSEUDO-TURPIN-PENN-P,1225,NarrativeProse,1207,304,1001,838,74,1511,1913,3424
1279-SOMME-ROYAL-PENN-P,1279,DidacticProse,2659,606,740,1145,78,3265,1963,5228
127X-CASSIDORUS-PENN-P,1275,NarrativeProse,3913,1069,1635,2555,437,4982,4627,9609
1283-LIVRE-ROISIN-MCVF-P,1283,Legal,404,100,96,24,10,504,130,634
1309-JOINVILLE-MCVF-P,1309,Diaries,5822,1325,2357,1944,182,7147,4483,11630
133X-PERCEFOREST-PENN-P,1335,NarrativeProse,3047,1029,1686,1532,228,4076,3446,7522
1369-FROISSART-1-MCVF-P,1369,NarrativeProse,1338,424,952,584,63,1762,1599,3361
1370-FROISSART-2-MCVF-P,1370,NarrativeProse,1285,506,893,693,64,1791,1650,3441
1371-FROISSART-3-MCVF-P,1371,NarrativeProse,1264,441,1047,634,56,1705,1737,3442
1372-FROISSART-4-MCVF-P,1372,NarrativeProse,1157,415,1046,675,41,1572,1762,3334
1374-FROISSART-5-MCVF-P,1374,NarrativeProse,1333,454,1048,739,56,1787,1843,3630
1375-FROISSART-6-MCVF-P,1375,NarrativeProse,1311,497,1094,684,48,1808,1826,3634
1376-FROISSART-7-MCVF-P,1376,NarrativeProse,1325,464,1032,724,68,1789,1824,3613
1377-FROISSART-8-MCVF-P,1377,NarrativeProse,1365,508,1031,671,43,1873,1745,3618
137X-PRISE-MCVF-R,1375,NarrativeMixed,3371,945,1658,1966,153,4316,3777,8093
1427-MORCHESNE-MCVF-P,1427,Legal,603,121,91,75,6,724,172,896
1450-XV-JOIES-MCVF-P,1450,NarrativeProse,2629,698,1392,906,163,3327,2461,5788
146X-CNNA-MCVF-P,1465,NarrativeProse,9974,3179,3924,4421,941,13153,9286,22439
1498-COMMYNES-MCVF-P,1498,NarrativeProse,2521,804,1249,1063,53,3325,2365,5690
1523-NOUVEAU-TESTAMENT-PENN-P,1523,Bible,2062,295,1774,1106,269,2357,3149,5506
1527-BAYART-PENN-P,1527,NarrativeProse,3501,1185,1191,1707,245,4686,3143,7829
158X-VALOIS-AUTOGRAPH-MCVF-P,1585,Letters,2086,578,242,656,56,2664,954,3618